--------------------------------
--------------------------------
--------------------------------
--------------------------------
--------------------------------
--------------------------------
--------------------------------
--------------------------------
pppppppppp------------pppppppppp
--------------------------------
--------------------------------
--------------------------------
----------pppppppppppp----------
--------------------------------
%------------------------------@
###########   ####   ###########
###########   ####   ###########
###########   ####   ###########