--------------------------------
--------------------------------
--------------------------------
--------------------------------
--------------------------------
--------------------------------
--------------------------------
--------------------------------
--------------------------------
--------------------------------
--------------------------------
--------------------------------
--------------------------------
------s-------------------------
%---------------e--------------@
###########   ####   ###########
###########   ####   ###########
###########   ####   ###########