--------------------------------
--------------------------------
--------------------------------
--------------------------------
--------------------------------
--------------------------------
--------------------------------
--------------------------------
pppppppppp------------pppppppppp
--------------------------------
--------------------------------
--------------------------------
----------pppppppppppp----------
--------------------------------
%-------#--------------#-------@
#########-----####-----#########
#########     ####     #########
#########     ####     #########